#######################################
# Syntax Coloring Map
#######################################
#######################################
# # Datatypes (KEYWORD1)
#######################################
FLProgRequestHandler	KEYWORD1
FLProgWebServer	KEYWORD1

#######################################
# Methods and Functions (KEYWORD2)
#######################################
add404Page	KEYWORD2
addHandler	KEYWORD2
argumentKeyAtIndex	KEYWORD2
argumentValueAtKey	KEYWORD2
argumentsCount	KEYWORD2
canHandle	KEYWORD2
getError	KEYWORD2
getStatus	KEYWORD2
handle	KEYWORD2
hasArgumentKey	KEYWORD2
hasHeaderKey	KEYWORD2
headerKeyAtIndex	KEYWORD2
headerValueAtKey	KEYWORD2
headersCount	KEYWORD2
host	KEYWORD2
method	KEYWORD2
methodVersion	KEYWORD2
pool	KEYWORD2
send403Page	KEYWORD2
sendDefault200Page	KEYWORD2
sendDefault404Page	KEYWORD2
sendJson	KEYWORD2
setCallBack	KEYWORD2
setMethod	KEYWORD2
setServer	KEYWORD2
setUri	KEYWORD2
uri	KEYWORD2
write	KEYWORD2

#######################################
# Constants (LITERAL1)
#######################################
FLPROG_WEB_SERVER_ACL	LITERAL1
FLPROG_WEB_SERVER_BIND	LITERAL1
FLPROG_WEB_SERVER_CHECKOUT	LITERAL1
FLPROG_WEB_SERVER_CONNECT	LITERAL1
FLPROG_WEB_SERVER_COPY	LITERAL1
FLPROG_WEB_SERVER_DELETE	LITERAL1
FLPROG_WEB_SERVER_GET	LITERAL1
FLPROG_WEB_SERVER_HEAD	LITERAL1
FLPROG_WEB_SERVER_INACTION_STEP	LITERAL1
FLPROG_WEB_SERVER_LINK	LITERAL1
FLPROG_WEB_SERVER_LOCK	LITERAL1
FLPROG_WEB_SERVER_MERGE	LITERAL1
FLPROG_WEB_SERVER_MKACTIVITY	LITERAL1
FLPROG_WEB_SERVER_MKCALENDAR	LITERAL1
FLPROG_WEB_SERVER_MKCOL	LITERAL1
FLPROG_WEB_SERVER_MOVE	LITERAL1
FLPROG_WEB_SERVER_MSEARCH	LITERAL1
FLPROG_WEB_SERVER_NOTIFY	LITERAL1
FLPROG_WEB_SERVER_OPTIONS	LITERAL1
FLPROG_WEB_SERVER_PARSE_GET_STEP_1	LITERAL1
FLPROG_WEB_SERVER_PARSE_GET_STEP_2	LITERAL1
FLPROG_WEB_SERVER_PARSE_GET_STEP_3	LITERAL1
FLPROG_WEB_SERVER_PARSE_POST_STEP_1	LITERAL1
FLPROG_WEB_SERVER_PARSE_POST_STEP_2	LITERAL1
FLPROG_WEB_SERVER_PATCH	LITERAL1
FLPROG_WEB_SERVER_POST	LITERAL1
FLPROG_WEB_SERVER_PROPFIND	LITERAL1
FLPROG_WEB_SERVER_PROPPATCH	LITERAL1
FLPROG_WEB_SERVER_PURGE	LITERAL1
FLPROG_WEB_SERVER_PUT	LITERAL1
FLPROG_WEB_SERVER_READ_FIRST_LINE_STEP	LITERAL1
FLPROG_WEB_SERVER_READ_SECOND_LINE_STEP	LITERAL1
FLPROG_WEB_SERVER_REBIND	LITERAL1
FLPROG_WEB_SERVER_REPORT	LITERAL1
FLPROG_WEB_SERVER_SEARCH	LITERAL1
FLPROG_WEB_SERVER_SENDING_SIZE	LITERAL1
FLPROG_WEB_SERVER_SUBSCRIBE	LITERAL1
FLPROG_WEB_SERVER_TRACE	LITERAL1
FLPROG_WEB_SERVER_UNBIND	LITERAL1
FLPROG_WEB_SERVER_UNLINK	LITERAL1
FLPROG_WEB_SERVER_UNLOCK	LITERAL1
FLPROG_WEB_SERVER_UNSUBSCRIBE	LITERAL1
FLPROG_WEB_SERVER_WORK_DATA_STEP_1	LITERAL1